111111
10PC01
10EC11
10E101
111111
