111111
100C11
1EPC11
111111
111111
